111111111111111111111111111111111111111111111
1P100001C00000X0010CX0100001000C0000000C00001
1C00010111111001010000111011000011CCCCCCCCCC1
10111101X0001X01C1C00C001110001001CXCCCCCCCC1
100001010000110001110110001C0110X1CCCCCCCCCC1
1C111100010000C0010C0100001111C001CCCCCCCXCC1
101000010111111111000100100C100011CCCCCCCCCC1
10111C0100000000010001011000101001CCCXCCCCCC1
1010CC01111111110110110100111010C1CCCCCCCCCC1
1C10100000000001001010010010001111CCCCXCXCCC1
1011111100010X0100101011E010000001XXXXXCXXXX1
1000C00111110101000010C11111110101XXXXCCXCCC1
1C0010010C01C101011111111C0000C0010XCC0C0CC01
11111X01100101011100C0X000010010010CX00C0XX01
1X0C0000C00001000001100010X1001CC10C0C0C0CC01
111111111111111111111111111111111111111111111