1111111111111111111111111111
10000000C000000000C010010001
1001011111000000001000010001
10010000C0000P00001CCCCCCCC1
1001000000000E00001010101001
10001111101100000C100000CC01
1111111111111111111111111111